..........
.......O..
..A.......
..........
...A...A..
.....O....
..A.O.....
..........
..........