..........
.......A..
..........
.A...A....
..........
.B...B....
..........
......B...
..........